#####################
####...##############
###.....#############
##.......############
##.......############
##.......############
###.....#############
####..~~#############
####.#~~~~###########
####.##~~############
####.################
###...###############
##.....##############
##.....##############
##.....##############
###...###############
#####################
#####################
#####################
#####################
#####################
