#########################################
########################...##############
#######################.................#
#######################.................#
#######################.................#
#######################.................#
#######################..........########
########################...##############
#########################################
#########################################
#########################################
