#####################
#####################
#####################
#####################
#####################
#######~~############
#######~~############
#######~~~###########
#######~~~###########
#######~~~###########
#######~~~###########
######~~~~~#......###
######~~~~~~.......##
######~~~~~~.......##
##....~~~~~........##
##...~~~~~.........##
##.....~~..#......###
##.........##########
#####################
#####################
#####################
