#####################
#####################
#####################
#####################
#####################
#############...#####
#######~~~~~.....####
#######~~~~~.....####
########~~~~.....####
########~~~~~...~####
###########~~~~.~####
############~~~.~####
#############~~.~####
#############~~.....#
###############.....#
###############.....#
###############.....#
###############.....#
###############.....#
#####################
#####################
