#####################
#####################
#####################
#.....###############
#.....###############
#.....~~~~~~#########
#.....###############
#.....###############
#.....###############
#.....###############
#####################
