#####################
#####################
#####################
#####################
#####################
#######~~~~~~########
########~~~~~~#######
########~~~~~~#######
########~~~~~########
#######~~~~~~########
#######~~~~~#########
######~~~~~~~########
#####...~~~~....#####
####............#####
####....~~##....#####
####.....~##....#####
####.....###....#####
####.....############
####.....############
#####...#############
#####################
