#####################
########.........####
###...##.........####
##.....#.........####
#................####
#....~.......########
#....~.......########
##...~.~~############
###..~#~~############
#####~~~#############
#####~~##############
#####~###############
#####################
#####################
#####################
#####################
#####################
#####################
#####################
#####################
#####################
