#####################
#####################
#####...#############
####.....############
####.....############
####.....############
#####...#############
#####.....###########
#####.....###########
#####.....###########
#####.....###########
######....###########
######....###########
######....###########
######....###########
######.~~~###########
########~############
#####################
#####################
#####################
#####################
