#########################################
#########################################
#########################################
########################...##############
#######################............#...##
#######################.................#
#######################.................#
#######################.................#
#######################............#...##
########################...##############
#########################################
