#########################################
#########################################
#########################################
#########################################
###############################......####
#########################............####
#########################.....#......####
#########################.....#......####
#########################.....#......####
#########################.....#......####
#########################################
