#####################
#####################
#####################
#######............##
#..................##
#..................##
#.......~~~........##
#......~~~~...~~~..##
#.....~~~~~..~~~~..##
######~~~~~..~~~...##
######~~~~~###~######
#####~~~~~~##########
#####~~~~~###########
#####~~~~~~##########
#####~~~~~~##########
#####~~~~~###########
#####################
#####################
#####################
#####################
#####################
