###############################
###############################
####........###################
####...............############
####..~~~~.........############
####.~~~~~~........############
####...............############
####........###################
###############################
###############################
###############################
