###########
###...#####
##.....####
#.......###
#.......###
#.......###
#.......###
##.....####
###...#####
###########
###########
