#####################
##.......############
##.......############
##.......############
##..~....############
####~~#~#############
####~~#~~~~~#########
#####################
#####################
#####################
#####################
