#####################
#####################
####.....############
###.......###########
###.......###########
###..~~~~~###########
####.~~~~############
#####################
#####################
#####################
#####################
