#####################
#####################
#####################
###....##############
##......#############
##......#############
##......#############
##......#############
###....##############
#####################
#####################
