#####################
#####################
#####################
#####################
####......###########
####......###########
####......###########
####......###########
####....~.###########
#####~~.~############
#####~~.~############
#######.#############
#######.#############
##......#############
#........############
#........############
#........############
#........############
##......#############
#####################
#####################
