#########################################
######.............######################
##...#.............######################
#..................######################
#...~..............######################
#...~~.....~~......######################
##...~~####~~###~~#######################
##...~...##~~~#~~~#######################
##.......###~~~~~~#######################
##.......####~~~~~#######################
##......~~~####~~########################
##.......####~~~#########################
##.......###~~~###~###...################
##.....~~~~~.~~~..........###############
###....~~~~~..~~~.........###############
###....~~~~~.~~~~.........###############
###.....~~~...............###############
###.......................###############
############...#..........###############
######################...################
#########################################
