#####################
#####################
###########....######
###########....######
##.......##....######
##...~...##....######
##...~...##....######
##..~~.........######
##..~~...##....######
##.......############
#####################
#####################
#####################
#####################
#####################
#####################
#####################
#####################
#####################
#####################
#####################
