#########################################
#############...#########################
############.....######....##############
###......##................##############
##........#.......#####....##############
##........~.......~~~##....##############
##........~~.....~~~###....##############
##......~.~##...~~~~###....##############
###.....~~###......~###....##############
####.#~~~~~##......~#####################
####.#~~~~~~#......~#####################
####.#~~~~~~~......######################
####.#~~~~~~~......######################
####.#~~~~~~~......######################
##.............~...######################
##......~~..........#####################
##..................#####################
##..................#####################
##.............#...######################
#########################################
#########################################
