#########################################
###............#...######################
###.................#####################
###.................#####################
###.................#####################
###.................#####################
###..~~~............#####################
###..~~~~~.....#...######################
##.....~~~###......######################
##...~~~~~~~#~~....######################
##...~~~~~~~#~~~...######################
##...~~~~~~~~~~~~..######################
##...~~~~~~~~~~~~~.######################
##...~~~~~~~~~~~~~.........##############
##...~.~~~~~~~~~~..........##############
##.....~~~~~~~~~~..........##############
##.......##~~..............##############
##.......###...............##############
#############...#########################
#########################################
#########################################
