#####################
#####################
#####################
#####################
#####################
#####################
#####################
#####################
#####################
#####################
#####################
#####################
##.....##############
##.....##############
##.....#~~~....######
##.............######
##.....~~~#....######
##.....####....######
#####################
#####################
#####################
