###########
###########
###########
#.......###
#.......###
#.......###
#....~..###
#....~..###
####~~~####
#####~~####
#####~~####
#####~#####
###########
###########
###########
###########
###########
###########
###########
###########
###########
