#########################################
#########################################
####...##################################
###...............#######################
###...............#######################
###...............#######################
###...............#######################
####...##################################
#########################################
#########################################
#########################################
