###########
###########
###########
##......###
#........##
#........##
#........##
#........##
##......###
###########
###########
