###############################
##############.........########
##############.........########
##############.............####
##############.............####
##############.............####
##############.............####
##############.............####
##################.........####
###############################
###############################
