#####################
#####################
#####################
#####################
#####################
#####################
#####################
#####################
#####################
#####################
#####################
#####################
##.........##########
##........~~#########
##...~~~.~~~#########
##...~~~~~~~~~~~#####
##...~~~~~~~~~..#####
##..............#####
##..............#####
########........#####
#####################
