#####################
#####################
#####################
#####################
#####################
#####################
#####################
#####################
#####################
#####################
#####################
#####################
#.....###############
#.....#######......##
#.....#######......##
#..................##
#.....#######......##
#.....###############
#####################
#####################
#####################
