#####################
#####################
##############...####
#############.....###
#############.....###
#############..~..###
#############.....###
##############...####
##############....###
##############....###
##############....###
###############...###
##############.....##
##############.....##
##############.....##
##############.....##
##############.....##
##############.....##
###############...###
#####################
#####################
