#####################
#####################
#####################
#############.....###
############.......##
############.......##
############.......##
############.......##
#############.....###
#############..~..###
#############~~~..###
#############~~~.####
#############~~~.####
############~~~~.####
##########~~~~~~.####
##########~~~~~..####
#############....####
#####################
#####################
#####################
#####################
