#####################
#############.......#
#############.......#
#############.......#
#######~~~###.......#
######~~~~~~~.......#
######~~~~~~#.......#
######~~~~~~#.......#
######~~~~###.......#
######~~~####.......#
######~~#####.......#
#############.......#
#############.......#
#############....####
#############....####
#############....####
#############....####
#####################
#####################
#####################
#####################
