#########################################
#########################################
#########################################
#########################################
#######################...###############
######################..................#
######################..................#
######################..................#
#######################...#.............#
###########################.............#
#########################################
