#####################
#####################
#####################
#####################
#####################
##############.~....#
##############......#
##############......#
##############......#
##############......#
#####################
