###########
###########
###.....###
##.......##
##.......##
##.......##
##.......##
###.....###
###########
###########
###########
