#####################
#####################
#####################
##############......#
######...#####......#
#####...............#
#####.....####.~....#
#####.....####~~#####
######...#####~~#####
#############~~~#####
#############~~~#####
##########~~~~~~~####
##########~~~~~~~####
##########~~~~~~~####
#############~~~#####
##############~~#####
#####################
#####################
#####################
#####################
#####################
