#####################
#####################
#####################
#####################
#####################
#.....###############
#.....###############
#.....###############
#.....###############
#.....###############
#.........###########
#.........###########
####......###########
####......###########
####......###########
####......###########
####......###########
#####################
#####################
#####################
#####################
