#########################################
#########################################
#########################################
###....##################################
##...............########################
##.............~~~#######################
##...~~.........~~#######################
###..~~~~~.......~~######################
#####~~~~~~.......~######################
###########.......#######################
###########.....~.#######################
###########.......#######################
############......#####......############
############......#####......############
############......#####......############
#....#######......#####......############
#............................############
#....#######......#####......############
#....#######......#######################
#....####################################
#########################################
