#########################################
#########################################
#########################################
#########################################
#######################...............###
#######################............~..###
#######################...............###
#######################...............###
############################..........###
############################..........###
#########################################
