###########
###########
###########
#####...###
####.....##
####.....##
####.~...##
#####~~.###
#####~~####
#####~#####
###########
###########
###########
###########
###########
###########
###########
###########
###########
###########
###########
