#####################
#####################
#############......##
#############......##
#############......##
#############..~...##
#############......##
#############......##
#############......##
#####################
#####################
