#####################
#####################
###...###############
##.....##############
#.......~############
#.....~~~~###########
#......~~############
##.....##############
###...###############
#####################
#####################
