###########
####......#
####......#
####......#
####......#
#####~#####
###########
###########
###########
###########
###########
