#####################
#####################
#####################
#####################
#.......#############
#.......#############
#.......#############
#.......#############
#.......#############
#.......#############
#.........###########
#.........###########
###.......###########
###..~....###########
###..~....###########
###..~....###########
###.......###########
###.......###########
###.......###########
#####################
#####################
