#####################
#####################
#####################
#####################
##....###############
##...~~~~############
##....###############
##....###############
##....###############
##....###############
#####################
