#####################
#####################
#####################
#####################
#####################
#############......##
###.................#
###.................#
###.................#
###.........#......##
#####################
#####################
#####################
#####################
#####################
#####################
#####################
#####################
#####################
#####################
#####################
