#########################################
#########################################
####################################...##
######################..................#
######################..................#
######################..................#
######################..................#
######################..................#
######################.............#...##
#########################################
#########################################
