#########################################
############..........###################
############..........###################
############...............######......##
############...............######......##
############...............##~~~~~~....##
############...............###~~~~~~...##
###################........###~~~..~...##
###################........###~~~......##
########################~~.~#~~~#......##
########################~~.~~~~###.######
#####################.......~~~....######
####################~..~~~~.~~~....######
#####################..~~~.........######
#####################..~~...~~~....######
#####################.......~~~....~#####
###############################....######
###############################....######
#########################################
#########################################
#########################################
