#####################
#####################
#####################
#####################
#####################
#####################
#####################
#####################
#####################
#####################
#####################
#####################
############~########
############~#.....##
####.~..............#
####.~..............#
####................#
####................#
####.........#.....##
####.........########
#####################
