#########################################
#############...#######....##############
############.....#..........#############
###########.................#############
###########.................#############
###########.................#############
###########.................#############
############.....######....##############
#############...#########################
#########################################
#########################################
