#####################
#####################
#############....####
############......###
###########........##
###########........##
###########........##
###########........##
############......###
#############....####
#####################
