#########################################
#########################################
#########################################
######......#############################
######..........#########################
######..........#########################
######..........#########################
######..........#########################
######..........#########################
##########......#########################
#########################################
