###############################
################...############
###############......##########
###############............####
###############.......~~.~~####
###############....~~~~~~~.####
###############............####
###############......##########
################...############
###############################
###############################
