#####################
#####################
######...############
#####.....###########
#####.....###########
#####.....###########
#####.....###########
#####.....###########
######...############
#####################
#####################
