###########
###########
####....###
###......##
##........#
##........#
##........#
###......##
####....###
###########
###########
