#####################
##############....###
#############......##
############........#
############........#
############........#
############........#
#############......##
##############....###
###############.#####
###############.#####
#############...#####
############.....####
###########.......###
###########.......###
###########.......###
###########.......###
############.....####
#############...#####
#####################
#####################
