#########################################
#########################################
#########################################
#########################################
###.......###############################
###.......###############################
###.......######~########################
###.......######~~~~~~~~~################
###.......######~~~~~~~~~~###############
#.........######~~~~~~~~~~~##############
#.........######~~#~~~~~~~~~#############
#.........###....~.~~~~~~~~~#############
#..................~~~~~~~~~.####......##
#...................~~~~~~~~..###......##
#....................~~~~~~............##
#....~................~~~~~...###......##
#...........#......#..........###......##
#######################......####......##
#########################################
#########################################
#########################################
