###########
###########
###########
####.....##
####.....##
####.~...##
####.~...##
####.~...##
####.....##
###########
###########
###########
###########
###########
###########
###########
###########
###########
###########
###########
###########
