#####################
#####################
#####################
######......#########
######............###
######............###
######............###
######............###
######............###
######............###
#####################
#####################
#####################
#####################
#####################
#####################
#####################
#####################
#####################
#####################
#####################
