#####################
############......###
###########........##
###########........##
###########........##
###########........##
############......###
#####################
#####################
#####################
#####################
