#####################
############......###
#######............##
#######............##
#..................##
#..........#......###
#..........##########
#..........##########
#..........##########
#####################
#####################
#####################
#####################
#####################
#####################
#####################
#####################
#####################
#####################
#####################
#####################
