#########################################
#########################################
#######################......############
#............#....#...........###########
#..............~~~............###########
#..............~~~~~..........###########
#.............................~##########
#.....~~~.............#...~~~~~~~########
#####~~~~~............####~~~~~~~~#######
######~~~~####....~#######~~~~~~~~#######
##############....~~~~####~~~~~~~~#######
##############...~~~~~#####~~~~~~~#######
##...............~~~#############~~~#####
##.................~~############~~~#####
##.........~~~~....#~#############~~#####
##.......~~~~~~....######################
#########...........#####################
#########...........#####################
#########...........#####################
###############....######################
#########################################
