###########
###########
##.....####
#.......###
#.......###
#.......###
##.....####
###########
###########
###########
###########
