#####################
#####################
#############.......#
#############.......#
#############.......#
#############.......#
#############.......#
#############.......#
#############.......#
#############.......#
#############.......#
#############.......#
#############.......#
##############....###
##############....###
##############....###
##############....###
##############....###
##############....###
##############....###
#####################
