#########################################
####################........#############
####################........#############
#############......#........#############
############................#############
############................#############
############...........##################
#############......######################
#########################################
#########################################
#########################################
