###########
###########
###########
###########
###########
#####~#####
#####.....#
#####.....#
#####.....#
#####.....#
###########
