#####################
#.....###############
#.....###############
#.....###############
#.....###############
#.....###############
#.....###############
#.....###############
#........############
#........############
#........############
#........############
#####....############
####......###########
####......###########
####......###########
####......###########
#####....############
#####################
#####################
#####################
