###########
###########
###########
###########
###########
###########
#####~#####
#####~#####
#####~#####
#####~#####
#####~#####
#####~#####
#####~#####
###......##
###......##
###......##
###......##
###......##
###########
###########
###########
