#########################################
#############.......#####################
#############.......#####################
#############..............##############
#############.......~~.~~..##############
#############......~~~~~~~.##############
#############......~~~~~~~.##############
#############....~~~~~~~~~....###########
############~...~~~~~~~~~~....###########
#############....~~~~~~~~~....###########
#############.....~~~~~~~.....###########
#############......~~~~~~.....###########
####.....####...######~~~#....###########
###.......##.....#########....##~~#######
###.......#.......########....~~~~#######
###...............########....~~~~~~#####
###.......#.......########....##~~~######
####.....##.......########....###########
############.....########################
#############...#########################
#########################################
