#####################
#####################
####...##############
###.....#############
###.....#############
###.....#############
###.....#############
###.....#############
###.....#############
####...##############
#####################
