#####################
##############.....##
#############.......#
#############.......#
#############.......#
############~~......#
############~~~~...##
############~~~~~...#
############~~~~~...#
############~~~~~...#
############~~~~~...#
#############~~~....#
#############.~~....#
#############.......#
#############.......#
#############.......#
#############.......#
#############.......#
#####################
#####################
#####################
