#####################
#############...#####
############.....####
###########.......###
###########.......###
###########....~..###
############.....####
#############...#####
#####################
#####################
#####################
