#####################
##############....###
#############......##
#############......##
#############......##
#############......##
#############......##
##############....###
#####################
#####################
#####################
