#####################
####....#############
###......#.....######
##.............######
##.............######
##.............######
##.............######
###......#.....######
####...~~#.....######
#######~~############
#####################
#####################
#####################
#####################
#####################
#####################
#####################
#####################
#####################
#####################
#####################
