#####################
#####################
#####################
#####################
###############....##
##############......#
##############......#
##############......#
##############......#
###############....##
#####################
