#####################
#####################
#.......#############
#.......#############
#.......#############
#.......#############
#.......#############
#.......#############
#.......#############
######.##############
######.##############
######.##############
######.~~############
####...~~~###########
###....~~~~~#########
###....~~~~~~########
###.....~~~~#########
####.....############
#####################
#####################
#####################
