#####################
#####################
#####################
##....###############
#......##############
#......##############
#......##############
##....###############
##.##################
##.##################
##.##################
##.##################
##...################
#.....###############
#.....###############
#.....###############
#.....###############
#.....###############
#.....###############
##...################
#####################
