#########################################
#########################################
#########################################
######################.........##########
######################.........#.....####
######################................###
######################................###
######################................###
######################................###
######################.........#.....####
#########################################
