###############################
###############################
##################.......######
##################.......######
##################.......######
##################.......######
###########..............######
###########..........##########
###########..........##########
###########..........##########
###############################
