#####################
#####################
#####################
#####################
#############...~####
#######........~~####
###............~~####
###...........~~~####
###.........#.~~#####
###.........###~#####
#####################
#####################
#####################
#####################
#####################
#####################
#####################
#####################
#####################
#####################
#####################
