#####################
#####################
####.....############
####.....############
####.....############
####.....~~~~########
####.....############
####.....############
####.....############
#####################
#####################
