#####################
#####################
#####################
###############....##
##############......#
#############~~~....#
#############~~~....#
##############~~....#
###############~...##
#################.###
#################.###
#################.###
###############...###
##############.....##
#############.......#
#############.......#
#############.......#
##############.....##
###############...###
#####################
#####################
