#########################################
##.............#...######################
##....................##....#############
##....................#......############
##............................###########
##..........................~~~##########
##............................###########
##.............#...####......############
########################....#############
#######################.......###########
#######################.......###########
################..............###########
##########~~#~~~..............###########
#########~~~~~~~..............###########
#########~~~~~~...............###########
######~~~~~~~~~...............###########
#######~~~~~..................###########
###########...................###########
###########............##################
############...##########################
#########################################
