#########################################
#########################################
#########################################
#########################################
#########################################
###############......~~~~~.~~############
###############........~~....############
###############..............############
###############..............############
###################..........############
#########################################
