#########################################
#########################################
#############....########################
##########........#######################
######...~........#######################
#####.............#######################
#####.............~######################
#####.............~######################
#####.......#....~#######################
#####~...~~~#~~~~~~######################
#####~.~#~~~#~~~~~~######################
#####~.~#~~~#~~~~~#######.....###########
###.......###############.....###########
###.......###......######.....###########
###.......###......######.....###########
###...........................###########
###.......###......#####~.....###########
###.......###############################
#########################################
#########################################
#########################################
