#####################
#####################
##......#############
#........############
#........############
#........############
#........############
##......#############
##.##################
##.##################
##.##################
##.##################
##.##################
##.###~~#############
#....~~~~~###########
#....~~~~~~~~~~~#####
#...~~~~~~~~~~~~~####
#.......#############
#.......#############
#.......#############
#####################
