###########
###########
###########
###########
###########
###########
###########
###########
###########
###########
###########
###########
#####~#####
###..~....#
###.......#
###.......#
###.......#
###.......#
###.......#
###.......#
###########
