###########
###########
###...#####
##.....####
##.....####
##...~.####
##.....####
##.....####
##.....####
###...#####
###########
