#####################
#####################
##.....##############
##.....##############
##.....#######....###
##.............~..###
##.....######~~~~.###
#############~~~~.###
#############~~~~.###
#############~~~~####
##############~~~####
###############~#####
#####################
#####################
#####################
#####################
#####################
#####################
#####################
#####################
#####################
