#####################
#####################
#####################
#####################
#####################
#############.....###
#############.....###
#############.....###
#############.....###
#############.....###
###############.#####
###############.#####
###############.#####
###############.#####
############.......##
############.......##
############.......##
############.......##
############.......##
############.......##
#####################
