#####################
##############...####
#######...........###
#######...........###
#######...........###
#######...........###
##...........#...####
##...........########
##...........########
##...........########
#####~###############
#####~###############
#####~###############
#####################
#####################
#####################
#####################
#####################
#####################
#####################
#####################
