#####################
#####################
#####################
###.....#############
###.....#############
###.....#############
###.....#############
###.....#############
###.....#############
###.....#############
###......############
###......############
###......############
####.....############
###.......###########
###.......###########
###.......###########
###.......###########
####.....############
#####################
#####################
