#####################
#####################
##...#########...####
#.................###
#.................###
#.................###
#.....~......#...####
##...~~~#############
#####~~~~############
#####~~~~############
######~~~############
######~~~############
#######~~############
#####################
#####################
#####################
#####################
#####################
#####################
#####################
#####################
