###########
####...####
###.....###
###.....###
###.....###
###.....###
###.....###
###.....###
####...####
###########
###########
