#####################
#############......##
#############......##
#############......##
#############......##
#############......##
#############......##
#####~######~......##
#####~~~~###~~~.~####
#####~~~~~~~~~~.#####
#####~~~~~~~#~~.#####
#####~~~~~~####.#####
######~~~~#####.#####
#######~~~~##.....###
#######~~~~#.......##
########~~##.......##
############.......##
#############.....###
#####################
#####################
#####################
