#####################
#####################
###.......###.......#
###.......###.......#
###.................#
###...~~~~###..~....#
###...~~~~###.~~....#
###...~~~~~~#~~~#####
#######~~~~~~~~~#####
#########~~~~~~~#####
##########~###~######
#####################
#####################
#####################
#####################
#####################
#####################
#####################
#####################
#####################
#####################
