#########################################
#########################################
#########################################
##############............###############
##############............###############
##############............#~~~###########
##############............#~~~###########
##############............~~~~~~#########
##############........~~~~~~~~~~~########
##############........~~~~.~~.~~~########
###############.#####.........##~########
###############.#~~~#.........###########
##....######~~~.~~~~~.........###########
#......####~~~....~~#.........###########
#......#~~#~~~....###.........###########
#.................~~#####.....###########
#......~~~~~~~....#######.....###########
#......#######....#######.....###########
#......##################.....###########
##....###################################
#########################################
