#####################
#####################
###########.......###
###########.......###
###########.......###
###########.......###
###########.......###
###########.......###
###########.......###
###########.......###
###########.......###
###########.......###
###########.......###
###########.......###
#############.....###
#############.....###
#############.....###
#############.....###
#############.....###
#############.....###
#####################
