#####################
#####################
#####################
###########.......###
###########.......###
###########.......###
###########.......###
###########.......###
###########.......###
###########.......###
###########.......###
###########.......###
#############.....###
#############.....###
############~~....###
###########~~~~~..###
#############~~~~.###
#############.....###
#####################
#####################
#####################
