#####################
#####################
#####################
#####################
#####################
#####################
########~############
#######~~~###########
######~~~~###########
######~~~~~##########
######~~~~~##########
######~~~~~~#########
##....~~~~~~#########
#...........#########
#...........###~#####
#.........~~~~~~...##
##....#.............#
#######.............#
#######.............#
#############......##
#####################
