###########
####....###
###......##
###......##
###......##
####....###
###########
###########
###########
###########
###########
