#########################################
################################......###
################################......###
#########################.............###
#########################....###......###
#########################....###......###
#########################....###......###
#########################....###......###
#########################....############
#########################....############
#########################################
