###############################
###############################
###############################
#############................##
#############................##
#############................##
#############................##
#############...........#######
#############...........#######
#############...........#######
###############################
