#####################
#####################
#############...#####
############.....####
############.....####
############.....####
############.....####
############.....####
#############...#####
#####################
#####################
