#########################################
#########################################
#########################.....###########
#########################.....######....#
#########################...............#
#########################.....######....#
#########################.....######....#
#########################.....######....#
#########################.....######....#
####################################....#
#########################################
