#####################
#####################
#####################
#####################
#####################
##############~~#####
############.......##
############.......##
############.......##
############.......##
#####################
