###########
###########
###########
###########
###########
##...~#####
##....#####
##....#####
##....#####
###########
###########
