###########
###########
####.....##
###.......#
###.......#
###..~....#
####.~...##
#####~#####
#####~#####
###########
###########
###########
###########
###########
###########
###########
###########
###########
###########
###########
###########
