#####################
#####################
#####################
###...###############
##.....##############
#.......~~###########
#.......~~~##########
#.......~~~~#########
##.....~~~~~#########
###...~~~~~~#########
#####.~~~~~~~########
####...~~~~~~########
###.....~###~########
##.......############
##.......############
##.......############
###.....#############
####...##############
#####################
#####################
#####################
