#####################
#####################
#####################
####......###########
####......##.....####
####......#.......###
####......#.......###
####..............###
####......##..~~.####
##############~~#####
##############~######
#############~~######
############~~~######
#####################
#####################
#####################
#####################
#####################
#####################
#####################
#####################
