#####################
#####################
#############...#####
############.....####
############.....####
############.....####
############.....####
############..~~.####
############..~~.####
#############.~~#####
###########....~#####
###########.~~~~#####
###########.~~~~#####
###########..~~~#####
###########.....#####
###########.....#####
###########.....#####
#####################
#####################
#####################
#####################
