###########
#####....##
####......#
####......#
####......#
####......#
####......#
####......#
#####....##
###########
###########
