#####################
#####################
#####...#############
####.....############
###.......###########
###.......###########
###.......###########
###.......###########
####.....############
#####...#############
##......#############
##......#############
##......#############
##......#############
##......#############
##......#############
##......#############
##......#############
#####################
#####################
#####################
