#####################
#####################
###.......###########
###.......###########
###.......###########
###..~....###########
###.~.....###########
###.......###########
#####################
#####################
#####################
