#####################
#####################
#####################
#####################
############~########
######~~~~~~~.....###
######~~~~~#......###
######~~~~##......###
############......###
#####################
#####################
