#####################
#####################
#####################
#############......##
############........#
############~.......#
############........#
#############......##
#####################
#####################
#####################
