#####################
#####################
##############...####
#############.....###
#############.....###
#############.....###
#############.....###
#############.....###
##############...####
#####################
#####################
