###############################
###############################
###########..........#......###
###########..................##
###########..................##
###########..................##
###########..........#......###
###########..........##########
###############################
###############################
###############################
