#########################################
#########################################
###############################.......###
##############################........###
##############################........###
##############################........###
#######################......#.##########
#######################......#.##########
#######################........##########
#######################......############
#########################################
