#########################################
#############################..........##
######################......#..........##
#####################..................##
#####################..................##
###############~~~~~~~.~...............##
###############~~~~###......#..........##
#############################..........##
#########################################
#########################################
#########################################
