#####################
#############....####
############......###
############......###
############......###
############......###
############......###
############......###
#############....####
#####################
#####################
