#########################################
#########################################
#########################################
################################.....####
######################....#####.......###
#####################......####...~...###
#####################......####.......###
#####################.................###
######################....######.....####
#########################################
#########################################
