#####################
#####################
#####################
#####################
#####################
###############....##
#########~~~~~#....##
#########~~~~~~....##
##########~~~~~....##
#########~~~~~~....##
#########~~~~~~....##
#######~~~~~~~.....##
#######~~~~~~~.....##
#####~~~~~~~~~.....##
#####~~~#~~~~#.....##
##############.....##
##############.....##
##############.....##
##############.....##
#####################
#####################
