#########################################
#########################################
######################............#....##
######################..................#
######################..................#
######################.....~~~~~.~~~....#
######################.............~~...#
######################............#....##
######################............#######
#########################################
#########################################
