#########################################
#########################################
######################............#######
######################..................#
######################..................#
######################..................#
######################..................#
######################..................#
######################............#######
#########################################
#########################################
