###########
####...####
###.....###
##.......##
##.......##
##.......##
###.....###
####...####
###########
###########
###########
