#####################
#####################
##########..........#
##########..........#
###......#..........#
##..................#
##...........##~#####
##...........#~~#####
##...........~~~#####
###......#####~~#####
##############~~#####
#####################
#####################
#####################
#####################
#####################
#####################
#####################
#####################
#####################
#####################
