###########
###....####
##......###
#........##
#........##
#........##
##......###
###....####
###########
###########
###########
