###########
###########
###########
###########
###########
###########
###########
###########
###########
###########
###########
###########
###########
#####~#####
####.~...##
###..~....#
###.......#
###.......#
###.......#
####.....##
###########
