###########
###########
###########
###########
###########
###########
###########
###########
###########
###########
###########
####.~.####
###..~..###
##.......##
##.......##
##.......##
###.....###
####...####
###########
###########
###########
