###########
######...##
#####.....#
#####.....#
#####.....#
#####.....#
#####.....#
#####.....#
######...##
###########
###########
