#####################
#####################
#####################
#......#~############
#......~~~###########
#......~~~###########
#......##############
#......##############
#......##############
#......##############
#####################
