#########################################
##.......################################
##.......################################
##.......####......######....############
##.................#####......###########
##.......##~~......#####......###########
##.......####......#####......###########
#############...~.............###########
#############...~..#####......###########
#############...~..######....############
###############~~~~#######.##############
#################~########.............##
#####################~~~##.............##
##################~~~~~~~~~~...........##
#################~~~~~~~~~~~...........##
#################~~~~~~~~~~~...........##
######################.................##
######################.............######
######################.............######
######################.............######
#########################################
