###########
###########
###########
#......####
#...~..####
#......####
#......####
#......####
#......####
###########
###########
