#####################
#####...#############
####.....############
####.....############
####.....############
####.....############
#####...#############
#####################
#####################
#####################
#####################
