#####################
#####################
############.....####
###########.......###
###########.......###
###########.......###
###########.......###
############.....####
############.....####
############.....####
############.....####
############.....####
############.....####
############.....####
############...######
###########.....#####
###########.....#####
###########.....#####
###########.....#####
############...######
#####################
