#########################################
#########################################
####.....################################
####.....################################
####.....################################
####.~~~~~###....########################
####.....####....########################
####.....####....########################
####.............########################
#########################################
#########################################
