#####################
###........##########
###..............####
###..............####
###..............####
###..............####
######~~~#.......####
######~~~~.......####
#######~~~.......####
#######~~~###########
#######~~~###########
######~~~~###########
######~~~~###########
#####~~~~~~##########
#####~~~~~~##########
######~~~~~##########
#####################
#####################
#####################
#####################
#####################
