#####################
#####################
###############...###
##############.....##
#############.......#
#############..~....#
#############.......#
#############.......#
##############.....##
###############...###
#####################
