#########################################
#########################################
###.....#################################
##...............########################
##...............########################
##...............########################
###.....#........########################
###..............########################
###.......###############################
###.......###############################
###.......###############################
###.......#############....##############
###.......########..........#############
###.......########..........#############
###.........................#############
###.........................#############
###.........................#############
###...................#....##############
###...........###########################
###...........###########################
#########################################
