#########################################
#################..........##############
############...............##############
############...............##############
############..............~##############
############...........~~~~~~~###########
############............~~.~~############
#################..........##############
#########################################
#########################################
#########################################
