#########################################
###############################.....#####
###############################.....#####
###############################.....#####
###############################.....#####
##########################~~~~~~.....####
###########################~~~~~.....####
###########################~~~~......####
###########################~~~#......####
###########################~~~#......####
###############################......####
##############...##############......####
##########...............######......####
##########...............#######~....####
###......#...................##~~.....###
##...........................~~~~.....###
##....................................###
##...........#...#...........###......###
###......#########...........###......###
##################...........####....####
#########################################
