#####################
#####################
#####################
#####################
#####################
###....~~.###########
###.......###########
###.......###########
###.......###########
###.......###########
#####################
