###########
###########
###.......#
###.......#
###...~...#
###..~....#
###.......#
###.......#
###.......#
###########
###########
