#####################
#####################
#####################
#####################
#####################
#####################
#####################
#####################
#####################
#####################
#####################
#####################
#####################
###......######...###
###................##
###......#####.....##
###......#####.....##
###......#####.....##
###############...###
#####################
#####################
