###########
###########
###########
###########
###########
###########
###########
###########
###########
###########
###########
###########
####...####
###.....###
###..~..###
###..~~.###
###...~.###
####...####
###########
###########
###########
