#####################
#####################
#.......#############
#.......#############
#.......#############
#.....~~~~###########
#.......#############
#.......#############
#.......#############
#####################
#####################
