#########################################
#########################################
##############################..........#
########################................#
########################................#
########################................#
########################................#
########################................#
########################................#
##################################......#
##################################......#
##############################..........#
##############################..........#
##############################..........#
###############........#.....#..........#
###############...................#######
###############...................#######
###############...................#######
###############........#.....############
#########################################
#########################################
