#########################################
#####################...........#########
#####################...........#########
#####################..................##
#####################..................##
############################...........##
############################...........##
############################...........##
############################...........##
############################...........##
#########################################
