#####################
#####################
##############.....##
#############.......#
#############...~...#
#############..~~...#
#############.......#
##############.....##
#####################
#####################
#####################
