#########################################
#########################################
###........##############################
###.............#########################
###.............#########################
###.............~~~~############~########
###.............~~#############~~~#######
##..............~~##########~~~~~~#######
##..............~~##########~~~~~~#######
##.....########.~~##########~~~~~~~~#####
##.....########.#############~~~#~~~~####
##.....#######....##########~~~~~~~~~####
##.....######......#########~~#~~~~~~####
##.....#####........#######~~~~~~~~~#####
##.....#####........##.....~~~~~#########
#.......####........##......~~~~#########
#.......####................#############
#.......#####......###......#############
##.....#######....####......#############
######################......#############
#########################################
