#####################
#####################
#####################
#####################
#############......##
#############......##
#############......##
#############......##
#############......##
#############......##
#############......##
#############......##
#############.....###
#############.....###
#############.....###
#############.....###
#############.....###
#####################
#####################
#####################
#####################
