#########################################
#.............###########################
#.................#######################
#.................#######################
#.................#######################
#..............~~~#######################
#############...~~.######################
##########~~~......######################
##########~~~......######################
###########~~......######################
############~......######################
#######................##################
#######................##################
#......................##...~~###########
#..............~~......#.....~###########
#....~.......~~~~~#...~~....~.~~#########
#............######...........###########
#............######...........###########
#............###########.....############
#########################...#############
#########################################
