#####################
#####################
#####################
#####################
####.......##########
####.......##########
####..............###
####..............###
####..............###
########..........###
#####################
#####################
#####################
#####################
#####################
#####################
#####################
#####################
#####################
#####################
#####################
