#####################
#......##############
#......##############
#......##############
#......##############
#......##############
#........############
#........############
#........############
#........############
#........############
#........############
#........############
##.......############
##.......############
##.......############
##.......############
##.......############
##.......############
##.......############
#####################
