#########################################
#########################################
####.......##############################
####..............#######################
####..............#######################
####.~.......~~~~~#######################
####..............#######################
####..............#######################
####.......##############################
#########################################
#########################################
