#########################################
#########################################
####.........############################
####.........############################
####.............########################
####..........~~~~~######################
####.............~#######################
####.............########################
########.........########################
########.........########################
#########################################
