#########################################
################...........##############
############...#...........##############
###########................##############
###########................##############
###########..........####################
############...##########################
#########################################
#########################################
#########################################
#########################################
