#####################
#####....############
####......###########
####......###########
####......#~~########
####.~~~.~~~~~#######
####.~~~~~#~~~#######
####......###########
#####....############
#####################
#####################
