###############################
###############################
####################........###
####################........###
################............###
################............###
################............###
################............###
###############################
###############################
###############################
