#########################################
#########################################
############...##########################
###.............#########################
###.............#########################
###.............#########################
###.............#########################
###.............#########################
###.............#########################
###........#...##########################
#########################################
