###########
###########
###########
###########
###########
###########
###########
###########
#####~~####
#####~~####
#####~#####
#####~#####
###......##
###..~...##
###..~...##
###..~...##
###......##
###......##
###......##
###########
###########
