#####################
#####################
###########.......###
###########.......###
###########.......###
###########.......###
###########.......###
###########.......###
###########.......###
###########.......###
###########.......###
#############...#####
############.....####
###########.......###
###########.......###
###########.......###
############.....####
#############...#####
#####################
#####################
#####################
