#####################
############....#####
###########......####
###########......####
###########......####
############....#####
#####################
#####################
#####################
#####################
#####################
