#####################
#####################
#####################
#####################
#####################
#####################
#####################
#####################
########~~~~~########
#######~~~~~~########
######~~~~~~~########
###....~~~~~~########
##....~~~...~########
##..........~~~~#####
##..........~......##
###.....~......~....#
#########...........#
#########...........#
#########...........#
#############......##
#####################
