#####################
###......############
##........###########
##........###########
##.......~~~#########
###...~~~~~~~########
#####################
#####################
#####################
#####################
#####################
