###########
###########
##.....####
##.....####
##.....####
##...~.####
##.....####
###########
###########
###########
###########
