#####################
#####################
###...............###
###...............###
###...............###
###.........~~~~..###
###..........~~~..###
###...............###
###...............###
#####################
#####################
#####################
#####################
#####################
#####################
#####################
#####################
#####################
#####################
#####################
#####################
