#####################
#############...#####
############.....####
############.....####
############.....####
######~~~~~~~~...####
######~~~~~~~~~.#####
######~~~~~~~~..#####
######~~~~~~~~..#####
#######~~~~~~...#####
#######~~~~~....#####
#######~~~~~....#####
#######~~~~~...######
#######~~~~....######
########~~#....######
###########....######
#####################
#####################
#####################
#####################
#####################
