#####################
#####################
#####################
#####################
#####################
#############.....###
#############.....###
#############.....###
#############.....###
#############.....###
#################.###
#################.###
############......###
############......###
############......###
############......###
############......###
############......###
############......###
#####################
#####################
