#####################
####....#############
###......############
##........###########
##........###########
##........###########
##........###########
###......############
####....#############
#####.###############
#####.###############
#####.###############
#####.###############
#......##############
#......##############
#......##############
#......##############
#......##############
#......##############
#......##############
#####################
