#####################
#......##############
#......##############
#......##############
#......##############
#......##############
#......#~############
#......~~############
#.....~~~~###########
#.....~~~############
#......##############
#......##############
##....###############
#......##############
#......##############
#......##############
##....###############
#####################
#####################
#####################
#####################
