#########################################
#################################....####
#######################.....####......###
#######################.....####......###
#######################.....####......###
#######################.~~............###
#######################.....####......###
#######################.....#####....####
#########################################
#########################################
#########################################
