#####################
#####################
#####################
#####################
#####################
#####################
#####################
#####################
#####################
#####################
#####################
##...##########~#####
#............~~~#####
#............########
#............#.....##
#...................#
#...................#
#...................#
##...#########.....##
#####################
#####################
