#####################
#####################
#####################
#####################
#####################
##....###############
#......##############
#......##############
#......##############
##....###############
#####################
