#####################
#####################
#...........#########
#...........#.....###
#..................##
#..................##
#..................##
#..................##
#############.....###
#####################
#####################
#####################
#####################
#####################
#####################
#####################
#####################
#####################
#####################
#####################
#####################
