###########
###########
###########
###########
###########
###########
###########
###########
###########
###########
###########
#####~#####
#####~~####
#####~~####
#####~#####
####.~.####
###.....###
###.....###
###.....###
####...####
###########
