#########################################
##....###################################
#..........##############################
#..........##############################
#.................#######################
#.................#######################
#.................#######################
#.................#######################
##....###################################
#########################################
#########################################
