#########################################
#########################################
#########################################
#####################...........#########
#####################...........#########
#####################...........#.....###
#####################..................##
#####################..................##
############################...........##
#################################.....###
#########################################
