#####################
#####################
#####################
#####################
#####################
#####..~~~~##########
#####.....###########
#####.....###########
#####.....###########
#####.....###########
#####################
