###########
###########
##....#####
##....#####
##....#####
##...~#####
###########
###########
###########
###########
###########
###########
###########
###########
###########
###########
###########
###########
###########
###########
###########
