###############################
###############################
###############################
###############################
###.........###################
###..~~............############
###................############
###................############
###................############
###................############
###############################
