#####################
##.....##############
#.......#############
#.......#############
#.......#############
#.......#############
##.....##############
#####################
#####################
#####################
#####################
