###########
##.......##
##.......##
##.......##
##.......##
##.......##
#####~#####
#####~#####
#####~#####
#####~#####
#####~#####
#####~#####
#####~#####
###########
###########
###########
###########
###########
###########
###########
###########
