###########
###########
###########
#....######
#....######
#....~#####
#....######
#....######
#....######
#....######
###########
