#####################
#####...#############
####.....############
###.......###########
###.....~.###########
###..~~~~~~~#########
###.......###########
####.....############
#####...#############
#####################
#####################
