#####################
####....#############
###......############
###......############
###......############
###......############
###......############
####....#############
#####################
#####################
#####################
