#####################
#####################
###.....#############
##.......############
##.......############
##.......############
##.......############
###.....#############
#####.###############
#####.###############
#####.###############
#####.###############
#####....############
#####.~..############
#####~~..############
#####~~..############
#####....############
#####....############
#####....############
#####################
#####################
