###########
###########
###########
###########
###########
###########
###########
###########
###########
###########
###########
#####...###
####.....##
###.......#
###.......#
###..~....#
####..~..##
#####...###
###########
###########
###########
