###########
###########
###########
###########
###########
###########
###########
###########
###########
###########
###########
###########
####~..####
###.~~..###
##..~~...##
##..~~...##
##..~....##
##.......##
###.....###
####...####
###########
