#########################################
#########################################
#########################################
#########################################
##..........#############################
##................#######################
##................#######################
##................#######################
##................#######################
##................#######################
#########################################
