#####################
###......############
###......############
###......############
###......############
###......############
#######.#############
#######.#############
#######.#############
#######.#############
#######.#############
#######.#############
#######.#############
#######.#############
#######.#############
###.......###########
###.......###########
###.......###########
###.......###########
#####################
#####################
