#####################
#####################
#####################
#####################
#############......##
#############......##
#############......##
#############......##
#############......##
#############......##
#############......##
#############......##
#############......##
#############......##
#############......##
############........#
############........#
############........#
#############......##
#####################
#####################
