#####################
#####################
#####################
#####################
#####################
#####################
#####################
#####################
#####################
#####################
#####################
#####################
############...######
######..........#####
######..........#####
######..........#####
######..........#####
######..........#####
######..........#####
######.....#...######
#####################
