#########################################
#########################################
####......###############################
####......###############################
####......#############......############
####....................~~~...###########
####......##......####.~~~~...###########
#.........##......####.~~~....###########
#.........##......####~~~~...############
#.........############~~~~###############
#.........############~~~~~##############
#.........############~~~~~##############
#.......~.##~~~~~~~~~~~~~~###############
#........~~~~~~~~~~~~####################
#........~~~~~~~~~~~~####################
#........~~~~~~~~~~~~####################
#..........~~~~~~~~######################
#................########################
#................########################
#####............########################
#########################################
