#########################################
#######.................#################
###.....................#################
###...........................#####...###
###...........................####.....##
###......~~~..................###.......#
###......~~~~..........~~~..............#
###.....~~~~~.....~~~~~~~~....###.......#
###.....~~~~~~####~~~~~~~~########.....##
###....~~~~~~~~####~~~~~~~#########...###
###...~~.~~~~~~##########################
###..~~~.~~~~~###########################
###..~~~.~~~#############################
####.~~~.~~~#############################
####.~...~~##############################
####.~~~.~~##############################
####.....################################
####.....################################
#########################################
#########################################
#########################################
