###########
###########
###########
###....####
###....####
###....####
###....####
###.~~.####
###.~~~####
###.~~~####
#####~#####
####~~#####
####~######
###########
###########
###########
###########
###########
###########
###########
###########
