###############################
###############################
########........###############
###.............###############
###.............###############
###.............###############
###.............###############
###.............###############
###........####################
###############################
###############################
