###########
###########
###########
###########
###########
###########
###########
#####~#####
#####~#####
####~~#####
####~~#####
##..~~.####
##...~.####
##.....####
##.....####
###########
###########
###########
###########
###########
###########
