#####################
#####################
##....###############
##....###############
##....###############
##....###############
#####.###############
#####.###############
#####.###############
#####.###############
#####.###############
#####.###############
#####.....###########
#####.....###########
#####.....###########
#####.....###########
#####.....###########
#####.....###########
#####.....###########
#####################
#####################
