###########
###########
###########
###########
###########
###########
###########
###########
###########
###########
###########
###########
#####...###
####.....##
###..~....#
###.~~....#
###.~~....#
###.......#
####.....##
#####...###
###########
