###########
###########
###....####
##......###
#........##
#........##
#........##
#........##
##...~..###
###..~.####
#####~#####
###########
###########
###########
###########
###########
###########
###########
###########
###########
###########
