#####################
#####################
#####################
#####################
##############....###
#############......##
#############......##
#############......##
#############......##
##############....###
###########.......###
###########.......###
###########.......###
###########....~~.###
###########...~~~.###
###########...~~~.###
###########.....~.###
###########.......###
###########.......###
###########.......###
#####################
