#####################
#####################
#####################
#####################
###########......####
###########......####
###########......####
###########......####
###########......####
###########......####
################.####
#############.......#
#############.......#
#############.......#
#############.......#
#############.......#
#####################
#####################
#####################
#####################
#####################
