#####################
###......############
##........###########
##........###########
##........###########
###......############
######.##############
######.##############
######.##############
######.##############
######.##############
######.##############
###.......###########
###.......###########
###.......###########
###.......###########
#####################
#####################
#####################
#####################
#####################
