#####################
#####################
#####################
###########....######
###########....######
###########....######
#######~~##....######
######~~~~~....######
######~~~~~~...######
######~~~~~....######
######~####.......###
###########.......###
###########.......###
###############...###
##############.....##
#############..~....#
#############...~...#
#############.......#
##############.....##
###############...###
#####################
