#####################
#####################
#############....####
############......###
###########....~~..##
###########...~~~..##
###########....~~..##
############......###
#############....####
#####################
#####################
