#####################
#####################
#####################
#####.....####......#
#####.....####......#
#####...............#
#####.....####......#
#####~########......#
#####~~##############
####~~~##############
####~~###############
####~~###############
#####~###############
####~~~~#~~##########
####~~~~~~~~#########
####~~~~~~~~#########
####~~~~#############
#####################
#####################
#####################
#####################
