#####################
#####################
#####################
#####################
############.....####
###########.......###
###########.......###
###########.......###
###########.......###
############.....####
#####################
