#####################
#####################
####.....############
###.......###########
###.......###########
###.......###########
####.....############
###.......###########
###.......###########
###.......###########
###.......###########
###.......###########
###.......###########
###.......###########
###.......###########
###.......###########
###.......###########
###.......###########
###.......###########
#####################
#####################
