#########################################
#####.......#############################
#####.......#############################
#####.......#############################
#####..............######################
#####....~~~.......######################
#####..............######################
#####..............######################
####......###############################
####......###############################
####......###############################
####........~................############
####.......~~~...............############
####.......~~~~..............############
####.......~~~~~.............############
####.....~~~~~~~~............############
########.....................############
########...............##################
#########################################
#########################################
#########################################
