#####################
#####################
###############.....#
###############.....#
###############.....#
###############.....#
###############.....#
###############.....#
###############.....#
##############.....##
##############.######
###########....######
###########....######
###########....######
###########....######
###########....######
#####################
#####################
#####################
#####################
#####################
