###########
###########
###########
##...######
#.....#####
#.....#####
#.....#####
##...######
###########
###########
###########
