###########
###########
###########
###########
###########
###########
###########
###########
###########
###########
###########
###########
#####~..###
####.~...##
####.~...##
####.~...##
####.....##
####.....##
#####...###
###########
###########
