###########
#####...###
####.....##
####.....##
####.....##
####.....##
####.....##
####.....##
#####...###
###########
###########
