#####################
#####################
############.....####
#.................###
#.................###
#....~~...........###
#.....~...~#.....####
#.....~~.~~##########
#.....~~~~~##########
#..........##########
#####################
#####################
#####################
#####################
#####################
#####################
#####################
#####################
#####################
#####################
#####################
