###############################
###############################
############....###############
###########...................#
###########...................#
###########...................#
###########...................#
###########...................#
############....#.............#
###############################
###############################
