#####################
#####################
#####################
#####################
###############~~..##
##############~~...##
###############....##
###############....##
###############....##
###############....##
#####################
