#####################
######...############
#####........##...###
#####........#.....##
#####...............#
######...#..........#
##########..........#
##########..........#
##############.....##
###############...###
#####################
#####################
#####################
#####################
#####################
#####################
#####################
#####################
#####################
#####################
#####################
