#####################
####.......##########
####.......##########
####.......##########
####.......#....#####
####....~~.......####
####...~~~.......####
####...~~........####
#######~~~.......####
#######~~~##....#####
#######~~~###########
#######~~~###########
#######~~~###########
#######~~~###########
#######~~~###########
########~############
#####################
#####################
#####################
#####################
#####################
