#####################
#####################
#####################
#####################
#############......##
#############......##
#############......##
#############......##
#############......##
##############.######
##############.######
##############.######
##############.######
##############.######
##############.######
##############....###
#############......##
#############......##
#############......##
##############....###
#####################
