#####################
#####################
#####################
#####################
#####################
#####################
#####################
#####################
#####~###############
#####~###############
#####~~##############
###.....#############
##.........##########
##.........##########
##...~.....#......###
###..~~.~..........##
#########..........##
#########..........##
############......###
#####################
#####################
