#####################
#####################
#####################
###############.....#
###############.....#
##########~~~~~.....#
###############.....#
###############.....#
###############.....#
###############.....#
#####################
