#########################################
#########################################
#########################################
#############..........##################
#############..........#.....############
#############............~.~~~###########
#############.................###########
#############.................###########
#############..........#.....############
#############..........##################
#########################################
