#####################
#####################
#......########....##
#......#######......#
#...................#
#......#######......#
#......#######......#
#......########....##
#......##############
#####################
#####################
#####################
#####################
#####################
#####################
#####################
#####################
#####################
#####################
#####################
#####################
