#####################
#####################
#############.......#
#############.......#
#############.......#
#############.......#
#############.......#
#############.......#
#############.......#
############........#
############........#
############....#####
###########......####
###########......####
###########......####
############....#####
#####################
#####################
#####################
#####################
#####################
