#####################
#####################
#####################
###.....#############
##.......############
##......~############
##......~############
###.....#############
#####################
#####################
#####################
