###############################
##################...........##
##################...........##
##################...........##
###########..................##
###########..................##
###########..................##
###########...........#########
###############################
###############################
###############################
