#####################
#####################
#####################
###############.....#
###############.....#
###############.....#
###############.....#
#############.......#
#############.......#
#############.......#
#############.......#
#############.......#
#############....####
#############....####
#############....####
#############..~.####
#############....####
#############....####
#####################
#####################
#####################
