#########################################
###############...#######################
##############.....#..........###########
#####....####.................###########
####......###.................~~#########
####......###................~~~~~#######
####......###...........~~#~~~~~#########
#####....~####.....~~~~~#################
#####.....~~#~~...~~~~~##################
#####.....~.......~~~~###################
#####.....#.......~~#####################
#####.....#.......#######################
#####.............#######################
#####.............#######################
######...~~.......#######################
######~~~~~.......#######################
######.~~.........#######################
######............#######################
######............#######################
######.....##############################
#########################################
