#####################
#####################
#####...#############
####.....############
###.......###########
###.......###########
###.......###########
###.......###########
####.....############
#####.~.#############
#.....~~#############
#......~~~###########
#......~~~~##########
#....~~~~~~##########
#....~~~~~###########
#...~~~~~~###########
#...~~~~~############
#....################
#....################
#####################
#####################
