#####################
###...###############
##.....##############
#.......#############
#.......#############
#.......#############
##.....##############
###...###############
#####################
#####################
#####################
