#########################################
############....#########################
##########.......########################
##########.......########################
###......#.......########################
##.........~....###~~~~##################
##...~............##~~~##################
##...~~...........#~~~###################
###...~..~~.~.....~~~~###################
#####~~~.~~~~.....##~####################
#####~##.~~~~.....#######################
#####~##.~~.......#######################
####.....#~...........##...##############
###.......#...........#.....#############
###.......#..................############
###.....~~#..................############
####.....##..................############
#######################.....#############
########################...##############
#########################################
#########################################
