#####################
#####################
#############....####
#############....####
#############....####
#############....####
#############....####
#########~~~~....####
########~~~~~.~..####
########~~~~~~~.#####
########~###~##.#####
########~##......####
########~##......####
###########......####
###########......####
###########......####
#####################
#####################
#####################
#####################
#####################
