#####################
############.....####
############.....####
############.....####
############.....####
###########~~~~~.####
############.....####
############.....####
#####################
#####################
#####################
