#####################
#####################
#####################
#####################
###......############
##........###########
##........###########
##........###########
##........###########
###......############
#####################
