#####################
#####################
##############....###
#############......##
#############......##
#############......##
#############......##
#############..~~..##
##############~~~.###
##############~~~.###
##############~~~.###
#############~~~~.###
############~~~~~.###
###########~~~~~..###
###########~~~~~...##
#######~~~~~~~~.....#
########~####.......#
#############.......#
##############.....##
###############...###
#####################
