#####################
#..................##
#.....#######......##
#.....#######......##
#.....#######......##
#.....#######..~...##
#.....#######..~...##
#############..~...##
#####################
#####################
#####################
#####################
#####################
#####################
#####################
#####################
#####################
#####################
#####################
#####################
#####################
