#####################
####....#############
####....#############
####....#############
####...~~~###########
####...~~~###########
####....#############
#####################
#####################
#####################
#####################
