#########################################
##...####################################
#.....###################################
#.....###################################
#....~~~~~###############################
##...~~~~~~##############################
#....~~~~~~##############################
#....~~~~~###############################
#......~~################################
#......~~################################
#.......#################################
#.......####......#######################
#.......###..........####################
#.......###....~~~.#.####################
#.......#......~~~~#.####################
#.........##...~~~~~.#..........#......##
#.......########~~~~.#..................#
#.......############....................#
#.......##############..................#
#.......#########################......##
#########################################
