#####################
###......############
##...........########
##..................#
##..................#
###......#.....~....#
##########.....~~...#
##########...~~~~...#
############~~~~~####
############~~~~~####
############~~~~#####
############~~~~#####
#####################
#####################
#####################
#####################
#####################
#####################
#####################
#####################
#####################
