#####################
#####################
###############....##
#######.............#
###.~...............#
###.~~..............#
###..~........#....##
###..~........#######
###.....~.....#######
###...........#######
#####################
#####################
#####################
#####################
#####################
#####################
#####################
#####################
#####################
#####################
#####################
