#####################
#####################
#####################
###.......#.......###
###...............###
###..~....#.......###
###.......#.......###
###.......###########
###.....~.###########
######~~~~###########
#####~~~~~####~######
#####~~~~~~~#~~~#####
#####~#~~~~~~~~~#####
#####~~~~~~~~~~~#####
#####~~~~~~~~~~######
######~~~~~~#########
#####################
#####################
#####################
#####################
#####################
