#####################
#####################
##......#############
#........############
#........############
#........############
##......#############
##......#############
##......#############
##......#############
##......#############
####....#############
###......############
###......############
###......############
###......############
###......############
###......############
####....#############
#####################
#####################
