###############################
###############################
###############################
#########...........###########
###.................###########
###.................###########
###.................###########
###.................###########
###............################
###............################
###############################
