#####################
#####################
#####################
#####################
#####################
#####################
#####################
#####################
#####################
#####################
#####################
#####################
#####~###############
#####~####........###
###......#........###
##.......~~~......###
##................###
##................###
##..........#########
###......############
#####################
