#########################################
#########################################
#########################################
###.....#################################
###.....###......########################
###.....###......########################
###.....###......########################
###..............########################
###########......########################
#########################################
#########################################
