###########
###########
###......##
##........#
##........#
##........#
###......##
###########
###########
###########
###########
