#########################################
#####........############################
#####............########################
#####............########################
#####............########################
#####..~~~.......########################
#####...~........########################
#####............########################
##########.......########################
#########################################
#########################################
