###############################
###############################
###############################
#.............#....############
#...................###########
#...................###########
#...................###########
#.............#....############
###############################
###############################
###############################
