#########################################
#########################################
###############...#######################
##############........###################
##############...............############
##############...............############
##############...............############
##############...............############
###############...#######################
#########################################
#########################################
