#####################
#####################
#####################
##############....###
#############..~~..##
############.~~~~...#
############........#
############........#
#############......##
##############....###
#####################
