###########
###....####
##......###
##......###
##......###
##......###
##......###
##......###
###....####
###########
###########
