###########
###########
##....#####
#......####
#......####
#......####
#......####
#......####
#......####
##....#####
###########
