#####################
#####################
#####################
#####################
#####################
#####################
######~###~~#########
######~~#~~~~~#######
######~~~~~~~~~~#####
#######~~~~~~~~~#####
#######~~~~~~~~~#####
#######~~~~~~~~~#####
#######~~~~~~~~~#####
#......#~~#~~~~~#####
#......#~######~#####
#......####...~~.####
#......####......####
#......####......####
#................####
#####################
#####################
