###########
###########
###....####
##......###
#........##
#........##
#........##
#........##
##...~..###
###....####
###########
###########
###########
###########
###########
###########
###########
###########
###########
###########
###########
