#########################################
#######################.........#########
#######################.........##....###
#######################.........#......##
#######################.................#
#######################.......~~~~~.....#
#######################........~~~~.....#
##############################~~~~~....##
##############################~~~~....###
#############################~~~~~.....##
#################~~~~~#~~~~~~~~~~~.....##
#################~#~~~~~~~~~~~~~~~.....##
#####################~~~~~~~~~~~~......##
###########.......##~~~~~~~~~~~~~......##
###########.......##~~#~~~.~~~.........##
###########.......##~~#................##
###########............................##
###########.......######.....#.........##
###########.......#######################
###########.......#######################
#########################################
