#####################
#####################
############.......##
############.......##
############.......##
###########~~......##
###########~~......##
###########~~......##
############.......##
###########~~~~....##
###########~~~~....##
#########~~~~~~....##
#######~~~~~~~.....##
########~~~~~......##
##############....###
#########~~~~......##
#############......##
#############......##
#############......##
##############....###
#####################
