#####################
##......#############
#........############
#........############
#........############
#........############
##......#############
#####################
#####################
#####################
#####################
