#########################################
#########################################
########..........#######################
##................#######################
##................#######################
##.............~..#######################
##................#######################
##.........##############################
#########################################
#########################################
#########################################
