#####################
#####################
#####################
###############...###
##############.....##
##############.....##
##############.....##
##############.....##
###############...###
#####################
#####################
