#####################
#############...#####
############.....####
############.....####
############.....####
############.....####
############.....####
######~~~~~~#...~####
######~~~~~~~~~.~####
#######~~~~~##~.~####
#######~~~#####.#####
########~~#####.#####
########~######.#####
###############.#####
#############......##
############........#
############........#
############........#
############........#
#############......##
#####################
