#####################
#####################
#####################
#####################
###########.....#####
#####~~~~~~.....#####
#####~~~~~~.....#####
######~~~~~.....#####
#######~~~~.......###
#######~~~~.......###
###########.......###
###########.......###
###########.......###
###########.......###
###########.......###
###########.......###
#####################
#####################
#####################
#####################
#####################
